HGNC	hallmarks of aging
A2M	'stem cell exhaustion','sterile inflammation'
AARS1	
AASS	'transcriptional alterations','accumulation of reactive oxygen species'
ABCA5	
ABCA8	
ABCA9	
ABCC4	'accumulation of reactive oxygen species'
ABCD3	
ABCE1	
ABCG1	
ABCG2	
ABHD1	
ABI2	
ABLIM1	
ABLIM2	'transcriptional alterations'
ABO	
ABR	
ACAA2	'impairment of the mitochondrial integrity and biogenesis'
ACADVL	'accumulation of reactive oxygen species'
ACAN	'degradation of proteolytic systems','changes in the extracellular matrix structure'
ACE	'degradation of proteolytic systems','stem cell exhaustion'
ACE2	'degradation of proteolytic systems'
ACF	
ACKR2	'sterile inflammation'
ACKR3	
ACOT13	
ACOT8	
ACOT9	
ACOX1	'accumulation of reactive oxygen species'
ACP1	
ACP2	
ACRV1	
ACSBG1	
ACSL5	
ACTA1	
ACTG1	
ACTN1	
ACTN4	
ACVR2A	'transcriptional alterations'
ACY3	
ADAM10	'degradation of proteolytic systems','intercellular communication impairment','changes in the extracellular matrix structure'
ADAM8	'degradation of proteolytic systems','sterile inflammation','changes in the extracellular matrix structure'
ADAMTS1	'degradation of proteolytic systems'
ADAMTS20	'degradation of proteolytic systems'
ADAMTS5	'degradation of proteolytic systems','changes in the extracellular matrix structure'
ADAP1	
ADCY1	'sterile inflammation'
ADCY3	
ADCY5	
ADD3	
ADGRE1	
ADGRE5	'sterile inflammation','intercellular communication impairment'
ADGRL1	
ADH1A	'accumulation of reactive oxygen species'
ADH1B	'accumulation of reactive oxygen species'
ADIPOQ	'AMPK pathway dysregulation','changes in the extracellular matrix structure'
ADIRF	'transcriptional alterations'
ADK	
ADPRS	'nuclear DNA instability'
ADRA1A	'intercellular communication impairment'
ADRA1B	'intercellular communication impairment'
ADRB2	'transcriptional alterations','AMPK pathway dysregulation'
AFG1L	'impairment of the mitochondrial integrity and biogenesis'
AGER	'sterile inflammation'
AGFG1	'nuclear architecture impairment'
AGFG2	
AGO2	'transcriptional alterations'
AGO4	'nuclear DNA instability'
AGPAT1	
AGT	'intercellular communication impairment'
AGTR1	'sterile inflammation'
AHCYL1	
AHCYL2	
AHNAK	
AHR	'transcriptional alterations'
AHSA2P	
AHSP	
AIDA	
AIF1	'sterile inflammation','intercellular communication impairment'
AIFM1	'nuclear DNA instability','accumulation of reactive oxygen species','intercellular communication impairment'
AIP	'transcriptional alterations'
AK2	
AKAP13	'AMPK pathway dysregulation'
AKAP7	
AKAP8	'nuclear DNA instability'
AKAP9	'intercellular communication impairment'
AKR1C2	'accumulation of reactive oxygen species'
AKT1	'transcriptional alterations','degradation of proteolytic systems','TOR pathway dysregulation','INS/IGF-1 pathway dysregulation','impairment of the mitochondrial integrity and biogenesis','sterile inflammation'
AKT1S1	'TOR pathway dysregulation'
AKT2	'INS/IGF-1 pathway dysregulation'
AKT3	'mitochondrial DNA instability','TOR pathway dysregulation','impairment of the mitochondrial integrity and biogenesis','senescent cells accumulation'
AKTIP	'nuclear DNA instability'
ALB	'intercellular communication impairment'
ALDH1B1	'accumulation of reactive oxygen species'
ALDH4A1	'accumulation of reactive oxygen species'
ALDH6A1	'accumulation of reactive oxygen species'
ALDH9A1	'accumulation of reactive oxygen species'
ALKBH7	'nuclear DNA instability','impairment of the mitochondrial integrity and biogenesis','accumulation of reactive oxygen species'
ALOX12	'accumulation of reactive oxygen species'
ALOX5AP	'accumulation of reactive oxygen species','sterile inflammation'
ALPK3	
AMOT	
AMOTL2	
ANAPC5	'degradation of proteolytic systems'
ANK2	'intercellular communication impairment'
ANK3	
ANKRD13C	
ANKRD20A9P	
ANP32B	'chromatin remodeling'
ANXA1	'nuclear DNA instability','sterile inflammation'
ANXA3	
ANXA4	'transcriptional alterations'
ANXA5	
ANXA7	'disabled macroautophagy'
AOX1	'accumulation of reactive oxygen species'
AP2B1	
AP3S1	'INS/IGF-1 pathway dysregulation'
AP4S1	
APBB1	'nuclear DNA instability','alterations in histone modifications','transcriptional alterations'
APBB3	
APC	'nuclear DNA instability','degradation of proteolytic systems','INS/IGF-1 pathway dysregulation'
APEX1	'nuclear DNA instability','telomere attrition','transcriptional alterations','accumulation of reactive oxygen species'
API5	
APOB	
APOBEC3A	
APOBEC3G	
APOC1	
APOC3	
APOD	
APOE	'intercellular communication impairment'
APP	'transcriptional alterations'
APPBP1	
APPBP2	'degradation of proteolytic systems'
AR	'transcriptional alterations','INS/IGF-1 pathway dysregulation','intercellular communication impairment'
ARAP3	
ARF3	
ARFGAP2	
ARFGEF1	
ARFIP1	
ARHGAP1	
ARHGAP29	
ARHGAP35	'intercellular communication impairment'
ARHGAP45	
ARHGEF18	
ARHGEF3	
ARHGEF5	
ARHGEF6	
ARHGEF7	
ARHGEF9	
ARIH1	'degradation of proteolytic systems'
ARL2BP	
ARMCX3	'transcriptional alterations','impairment of the mitochondrial integrity and biogenesis'
ARPC5L	
ARPP19	
ARPP21	
ASB12	
ASB17	
ASCC1	'nuclear DNA instability'
ASCL1	'transcriptional alterations'
ASF1A	'nuclear DNA instability','chromatin remodeling'
ASIC2	'intercellular communication impairment'
ASL	
ASMTL	
ASXL1	'alterations in histone modifications','transcriptional alterations','degradation of proteolytic systems'
ATF2	'nuclear DNA instability','alterations in histone modifications','transcriptional alterations','impairment of the mitochondrial integrity and biogenesis','intercellular communication impairment'
ATG12	'impairment of the mitochondrial integrity and biogenesis','disabled macroautophagy'
ATG4B	'degradation of proteolytic systems','impairment of the mitochondrial integrity and biogenesis','disabled macroautophagy'
ATG5	'impairment of the mitochondrial integrity and biogenesis','intercellular communication impairment','disabled macroautophagy'
ATM	'nuclear DNA instability','telomere attrition','alterations in histone modifications','transcriptional alterations','TOR pathway dysregulation','senescent cells accumulation'
ATOX1	
ATP1B4	
ATP2A2	'disabled macroautophagy'
ATP2B2	
ATP5F1A	
ATP5F1C	
ATP5MC1	
ATP5MC3	
ATP5ME	
ATP5PD	
ATP5PF	
ATP5PO	
ATP6V0B	
ATP6V1A	
ATP6V1G2	
ATP6V1H	
ATP7A	'impairment of the mitochondrial integrity and biogenesis','accumulation of reactive oxygen species','changes in the extracellular matrix structure'
ATPAF1	
ATR	'nuclear DNA instability','telomere attrition','senescent cells accumulation'
ATRX	'nuclear DNA instability','chromatin remodeling','transcriptional alterations','alterations in DNA methylation'
ATXN2	
AUH	
AVL9	
AVPI1	
AZIN1	
B3GALNT1	
B3GAT1	
B3GLCT	
B3GNT2	
B4GALT1	'sterile inflammation'
B4GAT1	
BACE2	'degradation of proteolytic systems'
BACH2	'transcriptional alterations'
BAD	'degradation of proteolytic systems','impairment of the mitochondrial integrity and biogenesis'
BAK1	'degradation of proteolytic systems','impairment of the mitochondrial integrity and biogenesis'
BAMBI	
BAX	'impairment of the mitochondrial integrity and biogenesis'
BAZ2A	'alterations in histone modifications','chromatin remodeling','transcriptional alterations','alterations in DNA methylation'
BBOX1	'accumulation of reactive oxygen species'
BCL11A	'transcriptional alterations'
BCL11B	'transcriptional alterations'
BCL2	'nuclear DNA instability','impairment of the mitochondrial integrity and biogenesis','accumulation of reactive oxygen species','stem cell exhaustion','intercellular communication impairment'
BCL2L2	'impairment of the mitochondrial integrity and biogenesis'
BCL3	'nuclear DNA instability','transcriptional alterations','sterile inflammation'
BCL6	'nuclear DNA instability','alterations in histone modifications','transcriptional alterations','senescent cells accumulation','sterile inflammation'
BCS1L	'impairment of the mitochondrial integrity and biogenesis'
BDNF	
BECN1	'impairment of the mitochondrial integrity and biogenesis','intercellular communication impairment','disabled macroautophagy'
BEND3	'alterations in histone modifications','chromatin remodeling','transcriptional alterations','alterations in DNA methylation'
BEND4	
BEX3	
BFSP1	
BHLHE41	'transcriptional alterations'
BIK	'impairment of the mitochondrial integrity and biogenesis'
BIN1	'nuclear architecture impairment','transcriptional alterations'
BIRC2	'degradation of proteolytic systems','sterile inflammation'
BIRC5	
BLM	'nuclear DNA instability','telomere attrition'
BLMH	'degradation of proteolytic systems'
BMAL1	'transcriptional alterations','degradation of proteolytic systems','TOR pathway dysregulation','senescent cells accumulation'
BMI1	'alterations in histone modifications','transcriptional alterations','alterations in DNA methylation','stem cell exhaustion'
BMP5	'transcriptional alterations','INS/IGF-1 pathway dysregulation'
BNIP3	'impairment of the mitochondrial integrity and biogenesis','accumulation of reactive oxygen species','disabled macroautophagy'
BNIP3L	'impairment of the mitochondrial integrity and biogenesis'
BOP1	
BPHL	
BPIFB4	
BRAF	'stem cell exhaustion'
BRAP	
BRCA1	'nuclear DNA instability','alterations in histone modifications','transcriptional alterations','alterations in DNA methylation','degradation of proteolytic systems'
BRCA2	'nuclear DNA instability','telomere attrition','alterations in histone modifications','senescent cells accumulation'
BRD1	'alterations in histone modifications','transcriptional alterations'
BRD2	'chromatin remodeling','transcriptional alterations'
BRF2	
BSCL2	
BTBD9	
BTNL2	
BTNL3	
BTRC	'degradation of proteolytic systems'
BUB1B	'nuclear DNA instability'
BUB3	
C10orf35	
C17orf75	
C1QA	'intercellular communication impairment'
C1QB	
C1QBP	'transcriptional alterations'
C1QC	
C1QL1	
C1S	'degradation of proteolytic systems'
C2	'degradation of proteolytic systems'
C3	'sterile inflammation'
C3AR1	'sterile inflammation'
C4A	'sterile inflammation'
C4B	
C5	'sterile inflammation'
C5AR1	'transcriptional alterations','sterile inflammation'
C7	
C9orf85	
CA14	
CA2	
CA3	
CA4	
CACNA1A	'intercellular communication impairment'
CACNA1C	'intercellular communication impairment'
CACNB1	'intercellular communication impairment'
CACNB2	'intercellular communication impairment'
CACNG1	
CACNG4	
CADM1	
CADM2	
CALB1	
CALB2	
CALD1	
CALM1	
CALM3	
CAMK2A	'impairment of the mitochondrial integrity and biogenesis'
CAMK2B	
CAMK4	'sterile inflammation'
CAMKK2	'AMPK pathway dysregulation'
CAMTA1	'transcriptional alterations'
CAP2	
CAPG	'changes in the extracellular matrix structure'
CAPN15	'degradation of proteolytic systems'
CAPN2	'degradation of proteolytic systems'
CAPN7	'degradation of proteolytic systems'
CAPZA2	
CARHSP1	
CARS1	
CASP1	'degradation of proteolytic systems'
CASP10	'degradation of proteolytic systems'
CASP2	'nuclear DNA instability','degradation of proteolytic systems'
CAST	
CAT	'accumulation of reactive oxygen species'
CAV1	'transcriptional alterations'
CAV2	'INS/IGF-1 pathway dysregulation','impairment of the mitochondrial integrity and biogenesis'
CBFA2T2	'transcriptional alterations'
CBLB	
CBS	'nuclear DNA instability','accumulation of reactive oxygen species','intercellular communication impairment'
CBX4	'transcriptional alterations'
CBX5	'nuclear DNA instability','transcriptional alterations'
CCDC88C	
CCKBR	
CCL5	'sterile inflammation','intercellular communication impairment'
CCN4	'intercellular communication impairment'
CCN5	'intercellular communication impairment'
CCND1	'nuclear DNA instability','transcriptional alterations'
CCND2	
CCNG2	
CCNH	'transcriptional alterations'
CCNL2	'transcriptional alterations'
CCR1	'sterile inflammation','intercellular communication impairment'
CCR7	'sterile inflammation'
CD14	'sterile inflammation'
CD163	'sterile inflammation'
CD244	
CD27	
CD28	'transcriptional alterations'
CD2AP	'degradation of proteolytic systems'
CD3G	
CD44	'sterile inflammation'
CD46	
CD47	
CD5	
CD55	
CD58	
CD59	
CD7	
CD80	
CD96	'sterile inflammation'
CDC14B	'nuclear DNA instability'
CDC16	'degradation of proteolytic systems'
CDC26	'degradation of proteolytic systems'
CDC40	
CDC42	
CDC42EP3	
CDC5L	'nuclear DNA instability','transcriptional alterations'
CDH13	'transcriptional alterations'
CDH22	
CDH4	
CDHR2	
CDK11A	
CDK13	
CDK2	'nuclear DNA instability','alterations in histone modifications','transcriptional alterations','senescent cells accumulation'
CDK5R1	
CDK7	'nuclear DNA instability','transcriptional alterations'
CDKN1A	'nuclear DNA instability','senescent cells accumulation','intercellular communication impairment'
CDKN2A	
CDKN2B	'senescent cells accumulation','intercellular communication impairment'
CDKN2B-AS1	
CDKN2C	
CDO1	'accumulation of reactive oxygen species','sterile inflammation'
CDV3	
CDYL	
CEACAM4	
CEBPA	'transcriptional alterations','impairment of the mitochondrial integrity and biogenesis'
CEBPB	'transcriptional alterations','sterile inflammation'
CELF1	
CELF2	
CELSR2	
CENATAC	
CENPO	'nuclear DNA instability'
CENPU	
CEP350	
CEP57	
CEP89	'impairment of the mitochondrial integrity and biogenesis','intercellular communication impairment'
CERS6	'sterile inflammation'
CERT1	'impairment of the mitochondrial integrity and biogenesis'
CETN3	
CETP	
CFB	'degradation of proteolytic systems'
CFDP1	'chromatin remodeling'
CFH	'degradation of proteolytic systems'
CFHR1	
CFLAR	'degradation of proteolytic systems'
CHAD	
CHCHD3	'impairment of the mitochondrial integrity and biogenesis'
CHCHD4	'accumulation of reactive oxygen species'
CHPT1	
CHRNA1	'intercellular communication impairment'
CHRNA3	'intercellular communication impairment'
CHRNA4	'nuclear DNA instability','intercellular communication impairment'
CHRNA5	'intercellular communication impairment'
CHRNA7	'intercellular communication impairment'
CHST2	'sterile inflammation'
CHSY1	
CHTF18	'nuclear DNA instability'
CILK1	
CIRBP	
CISD2	'impairment of the mitochondrial integrity and biogenesis','disabled macroautophagy'
CITED2	'transcriptional alterations','senescent cells accumulation'
CITED4	
CKLF	
CKMT2	
CLASRP	
CLDN5	
CLEC11A	
CLEC2B	
CLIC1	
CLIC2	'accumulation of reactive oxygen species'
CLIC4	
CLIP1	
CLK1	
CLN8	'impairment of the mitochondrial integrity and biogenesis'
CLOCK	'alterations in histone modifications','transcriptional alterations','degradation of proteolytic systems'
CLPX	'impairment of proteins folding and stability','degradation of proteolytic systems'
CLSTN1	
CLSTN2	
CLTB	
CLTC-IT1	
CLU	'impairment of proteins folding and stability','impairment of the mitochondrial integrity and biogenesis'
CMAS	
CMC2	
CMKLR2	
CMTM7	
CNIH4	
CNOT8	'transcriptional alterations'
CNR1	'intercellular communication impairment'
CNTN1	
COA1	
COBLL1	
COG5	
COL1A1	'intercellular communication impairment','changes in the extracellular matrix structure'
COL1A2	'changes in the extracellular matrix structure'
COL2A1	'changes in the extracellular matrix structure'
COL3A1	'changes in the extracellular matrix structure'
COL4A1	'changes in the extracellular matrix structure'
COL4A2	'transcriptional alterations','changes in the extracellular matrix structure'
COL4A3	'changes in the extracellular matrix structure'
COL4A4	'changes in the extracellular matrix structure'
COL4A5	'changes in the extracellular matrix structure'
COL4A6	'changes in the extracellular matrix structure'
COMT	'intercellular communication impairment'
COPA	
COPS5	'transcriptional alterations','degradation of proteolytic systems'
COPS6	'degradation of proteolytic systems'
COQ3	
COQ7	'accumulation of reactive oxygen species'
COX10	'impairment of the mitochondrial integrity and biogenesis'
COX11	'accumulation of reactive oxygen species'
COX4I1	'accumulation of reactive oxygen species'
COX7A2	'impairment of the mitochondrial integrity and biogenesis','accumulation of reactive oxygen species'
COX7A2P2	
COX7C	
CPD	'degradation of proteolytic systems'
CPNE1	'degradation of proteolytic systems'
CPNE3	
CPSF1	
CPSF2	
CPSF7	
CPT1B	
CR2	
CRADD	'nuclear DNA instability'
CREB1	'transcriptional alterations'
CREBBP	'alterations in histone modifications','transcriptional alterations'
CREBL2	'transcriptional alterations'
CREBZF	'transcriptional alterations'
CRH	'sterile inflammation','intercellular communication impairment'
CRIM1	'INS/IGF-1 pathway dysregulation'
CRKL	
CRP	'sterile inflammation'
CRTC3	'transcriptional alterations'
CRY2	'nuclear DNA instability','transcriptional alterations'
CRYAB	
CS	
CSF2	
CSMD1	
CSNK1A1	'degradation of proteolytic systems'
CSNK1E	'nuclear DNA instability'
CSNK2A1	'impairment of proteins folding and stability'
CSNK2A2	
CSPP1	
CSRP1	
CSTF3	
CTBP1	'chromatin remodeling','transcriptional alterations','accumulation of reactive oxygen species'
CTBS	
CTF1	'intercellular communication impairment'
CTGF	'INS/IGF-1 pathway dysregulation','accumulation of reactive oxygen species','changes in the extracellular matrix structure'
CTH	
CTNNA1	
CTNNB1	'transcriptional alterations','degradation of proteolytic systems','stem cell exhaustion','sterile inflammation','intercellular communication impairment'
CTNNBIP1	
CTSA	'degradation of proteolytic systems'
CUL4B	'nuclear DNA instability','alterations in histone modifications','degradation of proteolytic systems'
CX3CL1	'transcriptional alterations','sterile inflammation','intercellular communication impairment'
CX3CR1	'intercellular communication impairment'
CXCL1	'sterile inflammation'
CXCL10	'transcriptional alterations','sterile inflammation','intercellular communication impairment'
CXCL12	
CXCL14	'intercellular communication impairment'
CXCL16	
CXCL2	'sterile inflammation'
CXCL5	'sterile inflammation','intercellular communication impairment'
CXCL8	'sterile inflammation'
CXCL9	'sterile inflammation','intercellular communication impairment'
CXCR3	'sterile inflammation'
CXXC1	'alterations in histone modifications'
CYB561	'accumulation of reactive oxygen species'
CYB5R3	'accumulation of reactive oxygen species'
CYBB	'accumulation of reactive oxygen species','sterile inflammation'
CYC1	'accumulation of reactive oxygen species'
CYCS	'degradation of proteolytic systems','accumulation of reactive oxygen species'
CYFIP1	
CYGB	'accumulation of reactive oxygen species'
CYP19A1	'accumulation of reactive oxygen species'
CYP1B1	'accumulation of reactive oxygen species'
CYP1B1-AS1	
CYP2A6	'accumulation of reactive oxygen species'
CYP4X1	'accumulation of reactive oxygen species'
CYTH1	
DAAM1	
DAAM2	
DAZAP1	
DBN1	'intercellular communication impairment'
DCHS1	
DCK	
DCLRE1C	'nuclear DNA instability','telomere attrition'
DDIT3	'nuclear DNA instability','transcriptional alterations','degradation of proteolytic systems','accumulation of reactive oxygen species'
DDIT4	'TOR pathway dysregulation','accumulation of reactive oxygen species'
DDR1	
DDT	
DDX11	'nuclear DNA instability'
DDX12P	
DDX17	'transcriptional alterations'
DDX23	'chromatin remodeling'
DDX24	
DDX3X	'nuclear DNA instability','transcriptional alterations'
DDX42	
DDX55	
DEAF1	'transcriptional alterations'
DECR1	'accumulation of reactive oxygen species'
DEDD	
DEFA1	
DERL1	'degradation of proteolytic systems'
DEXI	
DFFB	'nuclear DNA instability'
DGAT1	
DGCR8	
DGKA	
DGKZ	
DHFR	'accumulation of reactive oxygen species'
DHFRP3	
DHRS3	'accumulation of reactive oxygen species'
DHX15	
DHX9	'nuclear DNA instability','transcriptional alterations','sterile inflammation'
DICER1	'nuclear DNA instability','transcriptional alterations'
DIDO1	'transcriptional alterations'
DIMT1	
DIS3	
DIXDC1	
DKK3	
DLAT	'accumulation of reactive oxygen species'
DLD	'degradation of proteolytic systems','accumulation of reactive oxygen species'
DLEU1	
DLG1	'transcriptional alterations','intercellular communication impairment'
DLK2	
DMD	
DMRT2	'transcriptional alterations'
DNAJA2	
DNAJC7	'impairment of proteins folding and stability'
DNASE1L1	
DNM1L	'impairment of the mitochondrial integrity and biogenesis'
DNPH1	
DNTTIP2	
DPEP2	'degradation of proteolytic systems'
DPF2	'chromatin remodeling','transcriptional alterations'
DPH5	
DPYD	'accumulation of reactive oxygen species'
DPYSL3	
DPYSL5	
DRD2	'transcriptional alterations','intercellular communication impairment','disabled macroautophagy'
DRD4	'intercellular communication impairment'
DSC1	
DSC2	'intercellular communication impairment'
DTNBP1	
DUSP10	
DUSP13	
DUSP19	
DUSP2	
DUSP4	
DUSP5	
DUSP6	
DUT	
DVL2	'transcriptional alterations'
DYNC1H1	
DYNC1I1	
DYRK1A	'alterations in histone modifications'
DYRK2	'nuclear DNA instability'
DYRK4	
DZIP3	
E2F1	'transcriptional alterations'
E2F4	'transcriptional alterations'
EBF1	'transcriptional alterations'
EBNA1BP2	
ECE1	'degradation of proteolytic systems'
ECHDC1	
ECHDC2	
ECI2	
ECM2	
ECPAS	'degradation of proteolytic systems'
ECSIT	
EDAR	
EDEM3	
EEF1A1	
EEF1E1	'senescent cells accumulation'
EEF2	
EEF2K	
EFCAB7	'transcriptional alterations'
EFEMP1	'changes in the extracellular matrix structure'
EFEMP2	'changes in the extracellular matrix structure'
EFS	
EFTUD2	
EGFL6	
EGFR	'transcriptional alterations'
EGLN1	'transcriptional alterations','accumulation of reactive oxygen species'
EGR1	'transcriptional alterations'
EGR2	'transcriptional alterations'
EGR3	'transcriptional alterations','intercellular communication impairment'
EHD3	
EHMT1	'alterations in histone modifications','chromatin remodeling','transcriptional alterations','alterations in DNA methylation'
EIF3M	
EIF4A1	
EIF4B	
EIF4EBP1	'TOR pathway dysregulation'
EIF4G3	
EIF4H	
EIF5A	'transcriptional alterations'
EIF5A2	
ELAVL1	
ELF2	'transcriptional alterations'
ELL2	'transcriptional alterations'
ELMO1	
ELMO3	
ELN	'changes in the extracellular matrix structure'
ELOVL5	
EML4	
ENPP5	'intercellular communication impairment'
ENSA	
ENTPD3	
EP300	'alterations in histone modifications','chromatin remodeling','transcriptional alterations'
EP400	'nuclear DNA instability','alterations in histone modifications','chromatin remodeling'
EPB41	
EPB41L2	
EPB41L3	
EPC1	'nuclear DNA instability','alterations in histone modifications','transcriptional alterations'
EPHA6	
EPHX2	
EPM2A	
EPOR	
EPS8	
ERAP2	'degradation of proteolytic systems'
ERBB2	
ERBB3	
ERCC1	'nuclear DNA instability','telomere attrition','senescent cells accumulation'
ERCC2	'nuclear DNA instability','transcriptional alterations','stem cell exhaustion'
ERCC3	'nuclear DNA instability','transcriptional alterations'
ERCC4	'nuclear DNA instability','telomere attrition'
ERCC5	'nuclear DNA instability'
ERCC6	
ERCC8	'nuclear DNA instability','degradation of proteolytic systems'
ERGIC3	
ERP27	
ESR1	'chromatin remodeling','transcriptional alterations','stem cell exhaustion'
ESR2	'transcriptional alterations','intercellular communication impairment'
ETF1	
ETFDH	'accumulation of reactive oxygen species'
ETNK1	
ETNPPL	
ETS2	'transcriptional alterations'
ETV6	'transcriptional alterations'
EWSR1	'transcriptional alterations'
EXO1	'nuclear DNA instability'
EXOC3L2	
EXOC5	
EXOC7	
EXOSC10	
EXOSC2	
EXOSC8	
EYA1	'nuclear DNA instability','alterations in histone modifications','transcriptional alterations'
EZH2	'alterations in histone modifications','chromatin remodeling','transcriptional alterations','alterations in DNA methylation','stem cell exhaustion','intercellular communication impairment'
F13A1	
FAAH	
FABP3	
FADS1	'accumulation of reactive oxygen species','intercellular communication impairment'
FAM107A	'intercellular communication impairment'
FAM13A	
FAM162A	
FAM210A	
FANCC	'nuclear DNA instability','accumulation of reactive oxygen species','stem cell exhaustion'
FANCG	'nuclear DNA instability','impairment of the mitochondrial integrity and biogenesis'
FANCL	'nuclear DNA instability'
FAS	'intercellular communication impairment'
FASTK	'impairment of the mitochondrial integrity and biogenesis'
FAXDC2	'accumulation of reactive oxygen species'
FBLN1	'changes in the extracellular matrix structure'
FBLN5	'changes in the extracellular matrix structure'
FBN1	'changes in the extracellular matrix structure'
FBN2	'changes in the extracellular matrix structure'
FBXL4	'degradation of proteolytic systems','impairment of the mitochondrial integrity and biogenesis','disabled macroautophagy'
FBXO21	'degradation of proteolytic systems'
FBXO22	'degradation of proteolytic systems','intercellular communication impairment'
FBXW11	'degradation of proteolytic systems'
FCER1A	
FCER1G	
FCGBP	
FCGR1A	'sterile inflammation'
FCGR2A	
FCGR3B	
FCGRT	
FCMR	
FDXR	'accumulation of reactive oxygen species'
FEN1	'nuclear DNA instability','telomere attrition'
FERMT2	
FES	'intercellular communication impairment'
FEZ1	'impairment of the mitochondrial integrity and biogenesis'
FEZ2	
FGF1	'transcriptional alterations'
FGF12	'intercellular communication impairment'
FGF13	'intercellular communication impairment'
FGF2	'transcriptional alterations','intercellular communication impairment'
FGF21	'intercellular communication impairment'
FGF23	'intercellular communication impairment'
FGFR1	
FGFR2	'transcriptional alterations','stem cell exhaustion','intercellular communication impairment'
FGFR3	'intercellular communication impairment'
FH	'nuclear DNA instability'
FHOD1	'transcriptional alterations'
FJX1	'intercellular communication impairment'
FKBP14	
FKBP1A	'impairment of proteins folding and stability'
FKBP5	'impairment of proteins folding and stability'
FLI1	'transcriptional alterations'
FLJ22555	'impairment of the mitochondrial integrity and biogenesis'
FLNA	
FLNB	
FLOT1	'changes in the extracellular matrix structure'
FLOT2	
FLRT3	
FLT1	
FLT3LG	
FLVCR2	
FN1	'sterile inflammation','changes in the extracellular matrix structure'
FN3KRP	
FNTA	
FOLH1	'degradation of proteolytic systems'
FOLH1B	'degradation of proteolytic systems'
FOLR1	'intercellular communication impairment'
FOLR2	'sterile inflammation','intercellular communication impairment'
FOS	'transcriptional alterations','alterations in DNA methylation','sterile inflammation','intercellular communication impairment'
FOSL2	'transcriptional alterations'
FOXC1	'transcriptional alterations'
FOXG1	'transcriptional alterations'
FOXJ3	'transcriptional alterations'
FOXM1	'nuclear DNA instability','transcriptional alterations'
FOXN3	'transcriptional alterations'
FOXO1	'nuclear DNA instability','transcriptional alterations','INS/IGF-1 pathway dysregulation','stem cell exhaustion','intercellular communication impairment','disabled macroautophagy'
FOXO3	'transcriptional alterations','impairment of the mitochondrial integrity and biogenesis','stem cell exhaustion','intercellular communication impairment'
FOXO4	'transcriptional alterations','INS/IGF-1 pathway dysregulation','stem cell exhaustion'
FPGT-TNNI3K	'intercellular communication impairment'
FRK	'transcriptional alterations'
FRMPD4	
FRY	
FRZB	'stem cell exhaustion'
FSHR	
FST	'transcriptional alterations'
FSTL5	
FTH1P5	
FTL	
FUBP3	'transcriptional alterations'
FUNDC2	'impairment of the mitochondrial integrity and biogenesis','disabled macroautophagy'
FURIN	'degradation of proteolytic systems','changes in the extracellular matrix structure'
FUS	'transcriptional alterations'
FUT6	
FXN	'degradation of proteolytic systems','impairment of the mitochondrial integrity and biogenesis','accumulation of reactive oxygen species'
FXR1	
FXYD5	
FYN	'sterile inflammation'
FZD2	
FZD3	
FZD7	'stem cell exhaustion'
FZD8	
FZR1	'nuclear DNA instability','degradation of proteolytic systems','senescent cells accumulation'
G3BP1	'nuclear DNA instability'
G3BP2	
G6PD	'accumulation of reactive oxygen species'
GABPA	'transcriptional alterations'
GABRB3	'intercellular communication impairment'
GABRD	'intercellular communication impairment'
GAD1	'intercellular communication impairment'
GADD45A	'nuclear DNA instability','transcriptional alterations'
GADD45G	
GAL3ST4	'intercellular communication impairment'
GALK2	
GALNT7	
GAPVD1	
GART	
GATAD1	'chromatin remodeling'
GATM	
GCLC	'impairment of the mitochondrial integrity and biogenesis','accumulation of reactive oxygen species'
GCLM	'impairment of the mitochondrial integrity and biogenesis'
GCN1	'intercellular communication impairment'
GDA	
GDE1	
GDF1	'SIRT pathway dysregulation'
GDF11	
GDF15	'intercellular communication impairment'
GDI2	
GET4	'degradation of proteolytic systems'
GFAP	
GFPT1	
GFRA2	
GGA2	
GGA3	
GGH	
GGT1	'degradation of proteolytic systems'
GGT7	
GH1	'INS/IGF-1 pathway dysregulation'
GHR	'INS/IGF-1 pathway dysregulation'
GHRH	'INS/IGF-1 pathway dysregulation','intercellular communication impairment'
GHRHR	'INS/IGF-1 pathway dysregulation'
GHRL	
GHSR	'INS/IGF-1 pathway dysregulation'
GIPC1	'intercellular communication impairment'
GIT2	
GJA1	'intercellular communication impairment'
GLE1	
GLG1	'degradation of proteolytic systems'
GLO1	'transcriptional alterations'
GLRX	'accumulation of reactive oxygen species'
GLRX2	'nuclear DNA instability','accumulation of reactive oxygen species','intercellular communication impairment'
GLRX3	'accumulation of reactive oxygen species'
GLUD1	'accumulation of reactive oxygen species'
GLYR1	'transcriptional alterations','accumulation of reactive oxygen species'
GMFB	
GNA11	
GNA12	'TOR pathway dysregulation'
GNA13	
GNAQ	
GNB5	
GNE	
GNG11	
GNG12	
GNPNAT1	
GNPTG	
GOLGA4	
GOLGB1	
GORASP2	
GOSR2	
GOT2	
GP5	
GPC4	
GPC5	
GPCPD1	
GPR137B	'TOR pathway dysregulation','disabled macroautophagy'
GPRC5B	
GPX1	'accumulation of reactive oxygen species'
GPX4	'accumulation of reactive oxygen species'
GRAMD2B	
GRAP2	'intercellular communication impairment'
GRHPR	'accumulation of reactive oxygen species'
GRIA1	'intercellular communication impairment'
GRIK2	'intercellular communication impairment'
GRIN2A	'degradation of proteolytic systems','intercellular communication impairment'
GRK2	
GRK5	
GRN	
GRSF1	
GSK3A	'transcriptional alterations','alterations in DNA methylation','degradation of proteolytic systems','TOR pathway dysregulation','INS/IGF-1 pathway dysregulation','impairment of the mitochondrial integrity and biogenesis'
GSK3B	'degradation of proteolytic systems','INS/IGF-1 pathway dysregulation','impairment of the mitochondrial integrity and biogenesis'
GSN	'changes in the extracellular matrix structure'
GSPT1	
GSR	'accumulation of reactive oxygen species'
GSS	
GSTA4	
GSTP1	'accumulation of reactive oxygen species'
GSTZ1	'accumulation of reactive oxygen species'
GUSBP1	
GYG1	
GYPC	
H1-10	'nuclear DNA instability','chromatin remodeling'
H2AC6	
H3-3B	'nuclear DNA instability','chromatin remodeling'
H4C3	'nuclear DNA instability','chromatin remodeling'
HABP4	'nuclear architecture impairment'
HADHA	'accumulation of reactive oxygen species'
HAUS7	
HBA1	'accumulation of reactive oxygen species'
HBA2	'accumulation of reactive oxygen species'
HBB	'accumulation of reactive oxygen species'
HBP1	'transcriptional alterations'
HCCS	
HCRTR2	'intercellular communication impairment'
HDAC1	'alterations in histone modifications','chromatin remodeling','transcriptional alterations'
HDAC2	'alterations in histone modifications','chromatin remodeling','transcriptional alterations'
HDAC3	'alterations in histone modifications','transcriptional alterations','TOR pathway dysregulation'
HDAC4	'alterations in histone modifications','chromatin remodeling','transcriptional alterations','sterile inflammation'
HDAC5	'alterations in histone modifications','chromatin remodeling','transcriptional alterations','sterile inflammation'
HDAC9	'alterations in histone modifications','transcriptional alterations','sterile inflammation'
HEBP2	'impairment of the mitochondrial integrity and biogenesis'
HELLS	'chromatin remodeling','alterations in DNA methylation'
HEPH	'accumulation of reactive oxygen species'
HERC1	'disabled macroautophagy'
HERC2P2	
HERC3	'degradation of proteolytic systems'
HERC4	'degradation of proteolytic systems'
HERC6	'degradation of proteolytic systems'
HGH1	
HGS	
HIBADH	'accumulation of reactive oxygen species'
HIBCH	
HIC1	'transcriptional alterations'
HIF1A	'transcriptional alterations','TOR pathway dysregulation'
HILPDA	'intercellular communication impairment'
HINFP	'nuclear DNA instability','transcriptional alterations'
HIPK3	'transcriptional alterations'
HLA-B	
HLA-C	
HLA-DMA	
HLA-DMB	
HLA-DOA	
HLA-DPA1	
HLA-DPB1	
HLA-DQA1	
HLA-DQB1	
HLA-DRA	
HLA-DRB1	'sterile inflammation'
HLA-DRB3	
HLA-DRB4	
HLA-DRB5	
HLA-DRB6	
HLA-E	
HLA-F	
HLA-G	'senescent cells accumulation'
HMBS	
HMGB1	'nuclear DNA instability','chromatin remodeling','transcriptional alterations','sterile inflammation','disabled macroautophagy'
HMGB2	'nuclear DNA instability','nuclear architecture impairment','chromatin remodeling','transcriptional alterations','sterile inflammation'
HMGN2	
HMGXB4	
HMOX2	'accumulation of reactive oxygen species'
HNF4A	'transcriptional alterations'
HNF4G	'transcriptional alterations'
HNRNPA1	'intercellular communication impairment'
HNRNPAB	
HNRNPC	'chromatin remodeling'
HNRNPD	
HNRNPH2	
HNRNPH3	
HNRNPK	'transcriptional alterations'
HNRNPL	'intercellular communication impairment'
HNRNPM	
HNRNPR	
HNRNPU	'transcriptional alterations'
HOPX	'alterations in histone modifications','transcriptional alterations'
HOXB2	'transcriptional alterations'
HOXB7	'transcriptional alterations'
HOXC4	'transcriptional alterations'
HP	'degradation of proteolytic systems','sterile inflammation'
HPCAL1	
HPGD	'accumulation of reactive oxygen species'
HPN	'degradation of proteolytic systems','changes in the extracellular matrix structure'
HPRT1	
HRAS	'transcriptional alterations','INS/IGF-1 pathway dysregulation','senescent cells accumulation'
HSD11B1	'accumulation of reactive oxygen species'
HSD17B6	'accumulation of reactive oxygen species'
HSD17B7	'accumulation of reactive oxygen species'
HSF1	'nuclear DNA instability','transcriptional alterations'
HSF2	'transcriptional alterations'
HSP90AA1	'nuclear DNA instability','telomere attrition','impairment of proteins folding and stability','impairment of the mitochondrial integrity and biogenesis'
HSP90AB1	'nuclear DNA instability','telomere attrition','impairment of proteins folding and stability'
HSP90B1	'impairment of proteins folding and stability','degradation of proteolytic systems'
HSPA13	'impairment of proteins folding and stability'
HSPA14	'impairment of proteins folding and stability'
HSPA1A	
HSPA1B	
HSPA2	'nuclear DNA instability','impairment of proteins folding and stability'
HSPA8	'impairment of proteins folding and stability','intercellular communication impairment'
HSPA9	'impairment of proteins folding and stability','impairment of the mitochondrial integrity and biogenesis'
HSPB8	
HSPD1	'impairment of proteins folding and stability','impairment of the mitochondrial integrity and biogenesis'
HTATSF1	'transcriptional alterations'
HTR1B	'intercellular communication impairment'
HTR2A	'intercellular communication impairment'
HTR3B	'intercellular communication impairment'
HTRA1	'degradation of proteolytic systems'
HTRA2	'degradation of proteolytic systems','impairment of the mitochondrial integrity and biogenesis'
HTT	
HYI	
HYKK	
HYPK	'impairment of proteins folding and stability'
ICAM1	
ICAM2	
ID2	'transcriptional alterations','senescent cells accumulation'
IDE	'degradation of proteolytic systems','INS/IGF-1 pathway dysregulation'
IDH1	'accumulation of reactive oxygen species'
IDH3A	'accumulation of reactive oxygen species'
IDS	
IFI16	'transcriptional alterations','degradation of proteolytic systems','sterile inflammation','intercellular communication impairment','disabled macroautophagy'
IFNAR1	
IFNG	'transcriptional alterations','sterile inflammation'
IGBP1	'transcriptional alterations'
IGF1	'transcriptional alterations','INS/IGF-1 pathway dysregulation'
IGF1R	'INS/IGF-1 pathway dysregulation','senescent cells accumulation','intercellular communication impairment'
IGF2	'transcriptional alterations','INS/IGF-1 pathway dysregulation'
IGF2R	'INS/IGF-1 pathway dysregulation'
IGFBP2	'INS/IGF-1 pathway dysregulation'
IGFBP3	'INS/IGF-1 pathway dysregulation'
IGFBP4	'INS/IGF-1 pathway dysregulation','sterile inflammation'
IGFBP5	'INS/IGF-1 pathway dysregulation'
IGFBP6	'INS/IGF-1 pathway dysregulation'
IKBKB	'transcriptional alterations','sterile inflammation'
IKZF1	'transcriptional alterations'
IL15	'sterile inflammation','intercellular communication impairment'
IL15RA	
IL16	
IL17RC	'sterile inflammation'
IL18	'transcriptional alterations','sterile inflammation','intercellular communication impairment'
IL1B	'transcriptional alterations','sterile inflammation','intercellular communication impairment'
IL1RN	'sterile inflammation'
IL2	'transcriptional alterations','intercellular communication impairment'
IL33	'transcriptional alterations'
IL6	'transcriptional alterations','sterile inflammation'
IL6ST	
IL7	'intercellular communication impairment'
IL7R	
ILF2	
IMMT	'impairment of the mitochondrial integrity and biogenesis'
IMPG1	'changes in the extracellular matrix structure'
ING1	'transcriptional alterations'
ING2	'transcriptional alterations','senescent cells accumulation','stem cell exhaustion'
INHBB	'intercellular communication impairment'
INPP1	
INPP4A	
INPP4B	
INPP5K	
INS	'INS/IGF-1 pathway dysregulation','sterile inflammation','intercellular communication impairment'
INSR	'INS/IGF-1 pathway dysregulation'
INVS	
IP6K3	
IQGAP1	
IRAG2	'nuclear architecture impairment'
IRF7	'nuclear DNA instability','transcriptional alterations'
IRS1	'INS/IGF-1 pathway dysregulation'
IRS2	'INS/IGF-1 pathway dysregulation'
ISCA1	
ITCH	'degradation of proteolytic systems','sterile inflammation'
ITGA2	
ITGA3	
ITGA4	
ITGA6	'transcriptional alterations','INS/IGF-1 pathway dysregulation'
ITGAE	
ITGAV	'INS/IGF-1 pathway dysregulation'
ITGB1	'stem cell exhaustion','sterile inflammation'
ITGB1BP2	
ITGB2	'sterile inflammation','intercellular communication impairment'
ITGB3	'INS/IGF-1 pathway dysregulation'
ITK	
ITM2A	
ITM2B	
ITPKA	
ITPKB	
ITPR2	
ITPRID2	
JAK1	
JAK2	'alterations in histone modifications','transcriptional alterations'
JMJD1A	'nuclear architecture impairment','alterations in histone modifications','transcriptional alterations','accumulation of reactive oxygen species'
JUN	'transcriptional alterations'
JUND	'transcriptional alterations'
KALRN	
KATNB1	
KAZALD1	'INS/IGF-1 pathway dysregulation'
KBTBD6	'degradation of proteolytic systems'
KCNA3	
KCNA5	
KCNJ16	
KCNJ9	
KCNK17	
KCNK3	'intercellular communication impairment'
KCNK4	
KCNT2	
KDM1A	'nuclear DNA instability','alterations in histone modifications','transcriptional alterations','accumulation of reactive oxygen species'
KDM2A	'nuclear DNA instability','alterations in histone modifications','transcriptional alterations','accumulation of reactive oxygen species'
KDM3B	'alterations in histone modifications','transcriptional alterations','accumulation of reactive oxygen species'
KDM5B	'alterations in histone modifications','chromatin remodeling','accumulation of reactive oxygen species'
KDM6B	'alterations in histone modifications','chromatin remodeling','transcriptional alterations','accumulation of reactive oxygen species','sterile inflammation'
KDM7A	'alterations in histone modifications','transcriptional alterations','accumulation of reactive oxygen species'
KDR	
KDSR	'accumulation of reactive oxygen species'
KHDRBS1	'transcriptional alterations'
KIAA1143	
KIAA1217	
KIF13B	
KIF1B	'intercellular communication impairment'
KIF2A	
KIF2C	
KIF3B	
KIF5B	
KIR3DX1	
KL	'INS/IGF-1 pathway dysregulation','sterile inflammation'
KLC1	
KLF13	'transcriptional alterations'
KLF3	'transcriptional alterations'
KLF4	'transcriptional alterations','stem cell exhaustion'
KLF5	'transcriptional alterations','intercellular communication impairment'
KLF6	'transcriptional alterations'
KLF7	'transcriptional alterations'
KLF9	'transcriptional alterations'
KLRD1	
KLRF1	
KPNA4	
KPNA5	
KRAS	'intercellular communication impairment'
KRT1	
KRT10	
KTN1	
LACTB	'degradation of proteolytic systems'
LAIR1	
LAMA2	'changes in the extracellular matrix structure'
LAMA3	'changes in the extracellular matrix structure'
LAMA4	'changes in the extracellular matrix structure'
LAMA5	'changes in the extracellular matrix structure'
LAMB1	'changes in the extracellular matrix structure'
LAMB2	'changes in the extracellular matrix structure'
LAMB3	'changes in the extracellular matrix structure'
LAMC2	'changes in the extracellular matrix structure'
LAMP2	'intercellular communication impairment'
LAMTOR2	'TOR pathway dysregulation'
LAMTOR5	'TOR pathway dysregulation'
LBH	
LCK	
LDLR	
LDLRAP1	
LEF1	'alterations in histone modifications','transcriptional alterations'
LEP	'transcriptional alterations','TOR pathway dysregulation','intercellular communication impairment'
LEPR	
LGALS1	
LGI1	
LGI4	
LGR5	
LGTN	
LIMCH1	
LIMK2	
LINS1	
LIPT1	
LITAF	'transcriptional alterations'
LMAN1	
LMNA	'nuclear DNA instability','nuclear architecture impairment','chromatin remodeling','senescent cells accumulation'
LMNB1	'nuclear architecture impairment','chromatin remodeling'
LNPEP	'degradation of proteolytic systems','intercellular communication impairment'
LNPK	
LOC105369165	
LOC105377989	
LOC105377992	
LOC107985852	
LONP1	'mitochondrial DNA instability','degradation of proteolytic systems','impairment of the mitochondrial integrity and biogenesis'
LOX	'accumulation of reactive oxygen species','changes in the extracellular matrix structure'
LOXL4	'accumulation of reactive oxygen species'
LPA	'degradation of proteolytic systems'
LPAR6	
LPIN1	'nuclear architecture impairment','transcriptional alterations'
LPP	
LRP1B	
LRP2	'INS/IGF-1 pathway dysregulation'
LRP4	
LRP8	'degradation of proteolytic systems','intercellular communication impairment'
LRRFIP1	'transcriptional alterations'
LSM10	
LSM2	
LSM4	
LSS	
LST1	
LTBP1	'changes in the extracellular matrix structure'
LTBP2	'changes in the extracellular matrix structure'
LY6G5C	
LY6G6F	
LYPLA1	
LYVE1	
MACF1	
MAD1L1	
MADD	
MAF	'transcriptional alterations'
MAFF	'transcriptional alterations'
MAFG	'transcriptional alterations'
MAGED1	'transcriptional alterations'
MAGED2	'transcriptional alterations'
MAGI3	
MAL	
MAN1A2	
MAN1C1	
MAN2A1	'impairment of the mitochondrial integrity and biogenesis'
MAOA	'accumulation of reactive oxygen species'
MAP1B	
MAP2K4	'senescent cells accumulation'
MAP3K2	
MAP3K5	'senescent cells accumulation','intercellular communication impairment'
MAP3K7	'alterations in histone modifications','sterile inflammation'
MAP3K7CL	
MAP3K8	
MAP3K9	
MAP4	
MAP4K1	
MAP4K3	
MAPK1	'nuclear DNA instability','INS/IGF-1 pathway dysregulation','intercellular communication impairment'
MAPK10	'senescent cells accumulation'
MAPK14	'transcriptional alterations','senescent cells accumulation','stem cell exhaustion'
MAPK3	'transcriptional alterations','INS/IGF-1 pathway dysregulation','intercellular communication impairment'
MAPK4	
MAPK8	'impairment of the mitochondrial integrity and biogenesis','senescent cells accumulation','intercellular communication impairment'
MAPK8IP3	
MAPK9	'senescent cells accumulation'
MAPKAP1	'TOR pathway dysregulation','intercellular communication impairment'
MAPRE2	
MAPT	'impairment of the mitochondrial integrity and biogenesis','intercellular communication impairment'
MARK1	
MAT2A	
MATR3	
MAX	'transcriptional alterations','intercellular communication impairment'
MBD4	'nuclear DNA instability'
MBNL1	
MBNL2	
MBOAT1	
MBP	'intercellular communication impairment'
MC2R	
MC4R	
MCL1	
MCM4	'nuclear DNA instability'
MCM7	'nuclear DNA instability'
MCTS1	'nuclear DNA instability'
MDC1	'nuclear DNA instability'
MDH2	'accumulation of reactive oxygen species'
MDM2	'transcriptional alterations','degradation of proteolytic systems'
ME1	'accumulation of reactive oxygen species'
ME3	'accumulation of reactive oxygen species'
MED16	'transcriptional alterations'
MED21	'transcriptional alterations','stem cell exhaustion'
MED28	'stem cell exhaustion'
MEGF8	
METTL1	
MFAP3L	
MFHAS1	'sterile inflammation'
MGAT4A	
MGAT5	
MGP	'changes in the extracellular matrix structure'
MGST1	'accumulation of reactive oxygen species'
MGST2	'accumulation of reactive oxygen species'
MICA	'nuclear DNA instability'
MICB	
MICOS13	'impairment of the mitochondrial integrity and biogenesis'
MID1IP1	
MID2	
MIER2	'alterations in histone modifications','transcriptional alterations'
MIF	'senescent cells accumulation','sterile inflammation'
MIPEP	'degradation of proteolytic systems'
MIR3156-3	
MKKS	
MKRN1	
MLC1	
MLF1	'transcriptional alterations'
MLH1	'nuclear DNA instability'
MLH3	'nuclear DNA instability'
MLXIP	'transcriptional alterations'
MMP1	'degradation of proteolytic systems','changes in the extracellular matrix structure'
MMP12	'transcriptional alterations','degradation of proteolytic systems','changes in the extracellular matrix structure'
MMP13	'degradation of proteolytic systems','changes in the extracellular matrix structure'
MMP14	'degradation of proteolytic systems','changes in the extracellular matrix structure'
MMP16	'degradation of proteolytic systems'
MMP17	'degradation of proteolytic systems'
MMP2	'degradation of proteolytic systems','changes in the extracellular matrix structure'
MMP20	'degradation of proteolytic systems','changes in the extracellular matrix structure'
MMP25	'degradation of proteolytic systems','sterile inflammation'
MMP27	'degradation of proteolytic systems'
MMP3	'degradation of proteolytic systems','changes in the extracellular matrix structure'
MMP7	'degradation of proteolytic systems','changes in the extracellular matrix structure'
MMP9	'degradation of proteolytic systems','changes in the extracellular matrix structure'
MOCS2	
MORF4	
MORF4L2	'nuclear DNA instability','alterations in histone modifications'
MOSPD1	'transcriptional alterations'
MPC1	
MPHOSPH8	'alterations in DNA methylation'
MPZL2	
MR1	
MRC1	
MRE11	'nuclear DNA instability','telomere attrition'
MRPL12	'transcriptional alterations','impairment of the mitochondrial integrity and biogenesis'
MRPL13	'impairment of the mitochondrial integrity and biogenesis'
MRPL15	'impairment of the mitochondrial integrity and biogenesis'
MRPL28	'impairment of the mitochondrial integrity and biogenesis'
MRPL30	'impairment of the mitochondrial integrity and biogenesis'
MRPL34	'impairment of the mitochondrial integrity and biogenesis'
MRPL35	'impairment of the mitochondrial integrity and biogenesis'
MRPL40	'impairment of the mitochondrial integrity and biogenesis'
MRPL41	'impairment of the mitochondrial integrity and biogenesis'
MRPL42	'impairment of the mitochondrial integrity and biogenesis'
MRPL48	'impairment of the mitochondrial integrity and biogenesis'
MRPL49	'impairment of the mitochondrial integrity and biogenesis'
MRPS12	'impairment of the mitochondrial integrity and biogenesis'
MRPS16	'impairment of the mitochondrial integrity and biogenesis'
MRPS18B	'impairment of the mitochondrial integrity and biogenesis'
MRPS24	'impairment of the mitochondrial integrity and biogenesis'
MRPS25	'impairment of the mitochondrial integrity and biogenesis'
MRPS28	'impairment of the mitochondrial integrity and biogenesis'
MRPS33	'impairment of the mitochondrial integrity and biogenesis'
MRPS5	'impairment of the mitochondrial integrity and biogenesis'
MSH2	'nuclear DNA instability'
MSH5	'nuclear DNA instability'
MSH6	'nuclear DNA instability'
MSN	
MSRA	'accumulation of reactive oxygen species'
MSRB2	'accumulation of reactive oxygen species'
MSTN	
MT-ATP6	
MT-CO1	'accumulation of reactive oxygen species'
MT-CYB	'accumulation of reactive oxygen species'
MT-ND4	'accumulation of reactive oxygen species'
MT-RNR1	
MT-RNR2	
MT1E	
MT1G	
MT1L	
MT1X	
MT2A	
MTA2	'alterations in histone modifications','chromatin remodeling','transcriptional alterations','alterations in DNA methylation'
MTBP	
MTFP1	'impairment of the mitochondrial integrity and biogenesis'
MTHFD1	'accumulation of reactive oxygen species'
MTHFR	'chromatin remodeling','accumulation of reactive oxygen species'
MTIF2	
MTIF3	
MTMR2	
MTMR4	
MTO1	'impairment of the mitochondrial integrity and biogenesis'
MTOR	'nuclear DNA instability','TOR pathway dysregulation','sterile inflammation','intercellular communication impairment'
MTR	
MTRR	'alterations in DNA methylation','accumulation of reactive oxygen species'
MTSS1	
MTTP	
MTUS1	
MTX2	'impairment of the mitochondrial integrity and biogenesis'
MXD1	'transcriptional alterations'
MXI1	'transcriptional alterations'
MXRA8	
MYBL1	'transcriptional alterations'
MYC	'nuclear DNA instability','chromatin remodeling','transcriptional alterations','alterations in DNA methylation'
MYD88	'sterile inflammation'
MYH8	
MYL10	
MYL12A	
MYO10	
MYO18A	
MYO6	'nuclear DNA instability','transcriptional alterations'
MYOF	
MZF1	'transcriptional alterations'
NAA38	
NABP2	'nuclear DNA instability'
NAMPT	'transcriptional alterations','INS/IGF-1 pathway dysregulation','intercellular communication impairment'
NAP1L1	'chromatin remodeling'
NAP1L2	'alterations in histone modifications','chromatin remodeling'
NAPA	'intercellular communication impairment'
NAPB	'intercellular communication impairment'
NAPG	
NBN	'nuclear DNA instability','telomere attrition'
NBR1	
NCAM2	
NCBP2AS2	
NCF4	'accumulation of reactive oxygen species'
NCK1	'transcriptional alterations'
NCOA2	'transcriptional alterations'
NCOA3	'alterations in histone modifications','transcriptional alterations'
NCOR2	'transcriptional alterations'
NDC1	'nuclear DNA instability','nuclear architecture impairment'
NDEL1	'nuclear architecture impairment','INS/IGF-1 pathway dysregulation'
NDFIP1	'degradation of proteolytic systems'
NDST1	'sterile inflammation'
NDUFA9	'accumulation of reactive oxygen species'
NDUFAF7	
NDUFB10	'accumulation of reactive oxygen species'
NDUFB3	'accumulation of reactive oxygen species'
NDUFB8	'accumulation of reactive oxygen species'
NDUFS2	'impairment of the mitochondrial integrity and biogenesis','accumulation of reactive oxygen species'
NDUFS3	'accumulation of reactive oxygen species'
NDUFS4	'accumulation of reactive oxygen species'
NDUFS5	'accumulation of reactive oxygen species'
NDUFV3	'impairment of the mitochondrial integrity and biogenesis','accumulation of reactive oxygen species'
NEBL	
NECAB3	
NECTIN2	'nuclear architecture impairment','impairment of the mitochondrial integrity and biogenesis'
NECTIN3	
NEDD4	'degradation of proteolytic systems'
NEK11	
NEK7	
NEK9	
NELL2	
NEU1	
NF1	'intercellular communication impairment'
NFATC2	'nuclear DNA instability','transcriptional alterations'
NFATC3	'transcriptional alterations','sterile inflammation'
NFE2L1	'transcriptional alterations'
NFE2L2	'transcriptional alterations','degradation of proteolytic systems','accumulation of reactive oxygen species','sterile inflammation','intercellular communication impairment'
NFKB1	'transcriptional alterations','sterile inflammation'
NFKB2	'transcriptional alterations'
NFKBIA	'transcriptional alterations','sterile inflammation'
NFX1	'transcriptional alterations','sterile inflammation'
NFYA	'alterations in histone modifications','transcriptional alterations'
NFYB	'alterations in histone modifications','transcriptional alterations'
NFYC	'alterations in histone modifications','transcriptional alterations'
NGB	
NGF	
NGFR	
NHLRC1	'degradation of proteolytic systems','disabled macroautophagy'
NIPBL	'nuclear DNA instability','transcriptional alterations','stem cell exhaustion'
NIPSNAP1	
NIPSNAP3B	
NISCH	
NKTR	
NKX2-2	'transcriptional alterations'
NKX3-1	'transcriptional alterations','INS/IGF-1 pathway dysregulation'
NLRC5	'transcriptional alterations'
NLRP1	'degradation of proteolytic systems','sterile inflammation'
NLRP3	'transcriptional alterations','sterile inflammation'
NMB	'intercellular communication impairment'
NME1	
NME2	'transcriptional alterations'
NME3	
NNMT	
NNT	'accumulation of reactive oxygen species'
NOG	'transcriptional alterations','stem cell exhaustion'
NOP56	
NOS1	'transcriptional alterations','accumulation of reactive oxygen species','intercellular communication impairment'
NOS1AP	
NOS3	'impairment of the mitochondrial integrity and biogenesis','accumulation of reactive oxygen species'
NOTCH1	'transcriptional alterations','stem cell exhaustion','sterile inflammation'
NOTCH2	'transcriptional alterations','sterile inflammation'
NOTCH3	'transcriptional alterations'
NOTCH4	'transcriptional alterations'
NOX4	'accumulation of reactive oxygen species','sterile inflammation'
NPC1	'TOR pathway dysregulation','disabled macroautophagy'
NPM1	'nuclear DNA instability','chromatin remodeling','transcriptional alterations','senescent cells accumulation'
NR1D1	'transcriptional alterations','degradation of proteolytic systems'
NR1D2	'transcriptional alterations'
NR2C2	'transcriptional alterations'
NR2F2	'transcriptional alterations'
NR3C1	'transcriptional alterations','sterile inflammation','intercellular communication impairment'
NR4A1	'transcriptional alterations'
NR4A2	'transcriptional alterations','intercellular communication impairment'
NR4A3	'transcriptional alterations'
NRCAM	
NRG1	'transcriptional alterations','stem cell exhaustion','intercellular communication impairment'
NRIP1	'transcriptional alterations'
NRM	
NRXN1	
NSF	
NSG1	'intercellular communication impairment'
NT5C2	
NTMT1	'alterations in histone modifications'
NUDT1	'nuclear DNA instability','intercellular communication impairment'
NUDT12	
NUDT21	
NUDT4	
NUDT6	
NUDT8	
NUMA1	'nuclear architecture impairment'
NUP153	'nuclear architecture impairment'
NUP188	
NUP43	
NUP50	
NUP58	
NUP62	'senescent cells accumulation'
NUP88	
NUP98	'nuclear architecture impairment','degradation of proteolytic systems'
NUSAP1	'nuclear DNA instability'
NUTF2	
NXT2	
OAS2	
OCRL	
OFD1	
OGFOD2	'accumulation of reactive oxygen species'
OGG1	'nuclear DNA instability','sterile inflammation'
OGT	'alterations in histone modifications','transcriptional alterations','degradation of proteolytic systems','impairment of the mitochondrial integrity and biogenesis','disabled macroautophagy'
OLFM1	
OLFM4	
OLIG2	'transcriptional alterations'
OPN3	
OR10C1	
ORC5	
OSBPL3	
OSBPL8	
OSBPL9	
OTOL1	'changes in the extracellular matrix structure'
OTUD4	'degradation of proteolytic systems'
OXA1L	'impairment of the mitochondrial integrity and biogenesis'
P2RX5	
P2RY14	
PABPC4	
PACS1	
PAFAH1B1	'nuclear architecture impairment','stem cell exhaustion','intercellular communication impairment'
PAFAH1B3	
PAIP1	
PAK1	'nuclear DNA instability','chromatin remodeling'
PAK1IP1	
PALLD	
PAM	'transcriptional alterations','accumulation of reactive oxygen species'
PANK3	
PANK4	
PANX1	'intercellular communication impairment'
PANX2	'intercellular communication impairment'
PAPOLA	
PAPPA	'degradation of proteolytic systems'
PAPSS1	
PAQR9	
PARD6A	
PARK7	'nuclear DNA instability','alterations in histone modifications','transcriptional alterations','degradation of proteolytic systems','impairment of the mitochondrial integrity and biogenesis','accumulation of reactive oxygen species','sterile inflammation','disabled macroautophagy'
PARP1	'mitochondrial DNA instability','nuclear DNA instability','telomere attrition','transcriptional alterations','alterations in DNA methylation','degradation of proteolytic systems','impairment of the mitochondrial integrity and biogenesis'
PARVG	
PATZ1	'transcriptional alterations'
PAWR	'transcriptional alterations','senescent cells accumulation'
PBXIP1	'alterations in histone modifications','sterile inflammation','changes in the extracellular matrix structure'
PCBD1	'accumulation of reactive oxygen species'
PCBD2	'accumulation of reactive oxygen species'
PCCA	
PCDH17	
PCGF2	'alterations in histone modifications','transcriptional alterations'
PCK1	'intercellular communication impairment'
PCMT1	
PCNA	'nuclear DNA instability','telomere attrition','transcriptional alterations'
PCNT	
PCSK9	'degradation of proteolytic systems','intercellular communication impairment'
PCTP	
PDCD4	
PDE3B	
PDE4A	
PDE4B	
PDE4D	
PDE4DIP	
PDE9A	
PDGFB	'accumulation of reactive oxygen species','intercellular communication impairment'
PDGFRA	
PDGFRB	
PDHA1	'accumulation of reactive oxygen species'
PDHB	'accumulation of reactive oxygen species'
PDK1	
PDK3	
PDLIM5	
PDS5A	'nuclear DNA instability'
PDSS1	
PECAM1	
PECR	'accumulation of reactive oxygen species'
PEDS1	'accumulation of reactive oxygen species'
PENK	'intercellular communication impairment'
PER2	'alterations in histone modifications','transcriptional alterations'
PERP	'degradation of proteolytic systems'
PET117	
PEX1	
PEX16	
PEX5	'impairment of proteins folding and stability','impairment of the mitochondrial integrity and biogenesis'
PFDN4	
PFKFB1	
PFKM	'transcriptional alterations'
PGGT1B	
PGK1	'degradation of proteolytic systems','accumulation of reactive oxygen species'
PGM5	
PGP	
PGPEP1	'degradation of proteolytic systems'
PHF20	'alterations in histone modifications','transcriptional alterations'
PHF3	'transcriptional alterations'
PHLDA1	
PHLPP1	
PHTF2	
PICALM	
PIERCE1	'nuclear DNA instability'
PIGK	'degradation of proteolytic systems'
PIGP	
PIK3C2A	'INS/IGF-1 pathway dysregulation'
PIK3CA	'alterations in DNA methylation','TOR pathway dysregulation','INS/IGF-1 pathway dysregulation'
PIK3CB	'disabled macroautophagy'
PIK3CD	'sterile inflammation'
PIK3R1	'transcriptional alterations','INS/IGF-1 pathway dysregulation'
PIN1	'transcriptional alterations'
PIP4K2B	
PITPNA	
PITPNB	'nuclear architecture impairment'
PITPNM1	
PKHD1	'TOR pathway dysregulation'
PKM	
PKN2	
PLA2G4B	'sterile inflammation'
PLAG1	'transcriptional alterations'
PLAGL1	'transcriptional alterations'
PLAU	'degradation of proteolytic systems'
PLCB1	'INS/IGF-1 pathway dysregulation'
PLCB4	
PLCE1	
PLCG2	
PLCH1	
PLCL1	'intercellular communication impairment'
PLCL2	'intercellular communication impairment'
PLD3	'sterile inflammation'
PLEK	
PLIN3	'intercellular communication impairment'
PLP1	'sterile inflammation','intercellular communication impairment'
PLPP1	
PLSCR3	
PLXNB1	
PLXNC1	
PMAIP1	'nuclear DNA instability','degradation of proteolytic systems','impairment of the mitochondrial integrity and biogenesis','accumulation of reactive oxygen species','intercellular communication impairment'
PMCH	'intercellular communication impairment'
PMF1	'transcriptional alterations'
PML	'nuclear architecture impairment','degradation of proteolytic systems','senescent cells accumulation'
PMP22	'intercellular communication impairment'
PNKP	'nuclear DNA instability'
PNPLA6	
PODXL	
POLA1	'nuclear DNA instability'
POLB	'nuclear DNA instability','sterile inflammation'
POLD1	'nuclear DNA instability'
POLD4	
POLE4	
POLG	
POLI	'nuclear DNA instability'
POLR1F	'nuclear DNA instability'
POLR2J2	'nuclear DNA instability','transcriptional alterations'
POLR3K	'nuclear DNA instability','transcriptional alterations'
POLRMT	'transcriptional alterations','impairment of the mitochondrial integrity and biogenesis'
POM121C	
POMT1	
PON1	
PON2	
POP5	
PORCN	
POU1F1	'transcriptional alterations'
POU5F1	'transcriptional alterations','stem cell exhaustion'
PPARA	'transcriptional alterations','intercellular communication impairment'
PPARG	'transcriptional alterations'
PPARGC1A	'transcriptional alterations','impairment of the mitochondrial integrity and biogenesis'
PPFIA1	
PPIA	
PPIC	
PPIF	'impairment of the mitochondrial integrity and biogenesis'
PPM1B	
PPM1D	'chromatin remodeling','alterations in DNA methylation','intercellular communication impairment'
PPM1E	
PPM1H	
PPP1CA	
PPP1R13B	
PPP1R2	
PPP1R26	
PPP2R1A	'nuclear DNA instability'
PPP2R2C	
PPP2R5C	'degradation of proteolytic systems'
PPP3R1	'transcriptional alterations'
PRDX1	'accumulation of reactive oxygen species'
PRDX3	'impairment of the mitochondrial integrity and biogenesis','accumulation of reactive oxygen species'
PRDX6	'accumulation of reactive oxygen species'
PREPL	'degradation of proteolytic systems'
PRIM1	'nuclear DNA instability'
PRKACB	'AMPK pathway dysregulation'
PRKAG1	'AMPK pathway dysregulation','intercellular communication impairment'
PRKAR1A	'transcriptional alterations','AMPK pathway dysregulation'
PRKAR2A	'AMPK pathway dysregulation'
PRKAR2B	'AMPK pathway dysregulation'
PRKCA	'nuclear architecture impairment','alterations in histone modifications'
PRKCB	'nuclear architecture impairment','alterations in histone modifications','transcriptional alterations'
PRKCD	'senescent cells accumulation'
PRKCG	'intercellular communication impairment'
PRKCH	
PRKCI	
PRKCQ	'degradation of proteolytic systems','sterile inflammation'
PRKCZ	'sterile inflammation'
PRKD3	
PRKDC	'nuclear DNA instability','telomere attrition','transcriptional alterations'
PRL	
PRMT2	'alterations in histone modifications'
PRNP	
PROP1	'transcriptional alterations'
PROX2	'transcriptional alterations'
PRPF3	
PRPF31	
PRPF40A	
PRPS1	
PRR5	'TOR pathway dysregulation','intercellular communication impairment'
PRR5L	'TOR pathway dysregulation'
PSEN1	'nuclear DNA instability','transcriptional alterations','degradation of proteolytic systems','disabled macroautophagy'
PSG7	
PSMB4	'degradation of proteolytic systems'
PSMC6	'degradation of proteolytic systems'
PSMD5	
PSME3IP1	
PSORS1C3	
PSRC1	
PTBP1	
PTBP3	
PTEN	'senescent cells accumulation','intercellular communication impairment'
PTGDR	'sterile inflammation'
PTGER2	'sterile inflammation'
PTGES2	'accumulation of reactive oxygen species'
PTGR1	'accumulation of reactive oxygen species'
PTGS2	'accumulation of reactive oxygen species','sterile inflammation'
PTK2	
PTP4A2	
PTPN1	'INS/IGF-1 pathway dysregulation'
PTPN11	
PTPN3	
PTPN6	
PTPRE	
PTPRJ	
PTPRK	
PTPRM	
PTTG1	'nuclear DNA instability'
PUM2	'nuclear DNA instability','impairment of the mitochondrial integrity and biogenesis'
PXN	'transcriptional alterations'
PYCR1	'accumulation of reactive oxygen species'
PYHIN1	
QKI	
QPCT	
QRSL1	'impairment of the mitochondrial integrity and biogenesis'
QSOX1	'accumulation of reactive oxygen species','changes in the extracellular matrix structure'
RAB10	
RAB13	
RAB18	
RAB1A	'disabled macroautophagy'
RAB21	
RAB2A	
RAB33A	
RAB33B	'disabled macroautophagy'
RAB3A	'impairment of the mitochondrial integrity and biogenesis','intercellular communication impairment'
RAB40C	
RAB4A	
RAB5A	
RAB6A	
RABEP1	
RABEP2	
RABGGTA	
RABGGTB	
RAC2	
RAD21	'nuclear DNA instability','transcriptional alterations'
RAD23A	'nuclear DNA instability','degradation of proteolytic systems'
RAD23B	'nuclear DNA instability','degradation of proteolytic systems'
RAD50	'nuclear DNA instability','telomere attrition'
RAD51	'nuclear DNA instability','telomere attrition','alterations in histone modifications'
RAD51B	'nuclear DNA instability'
RAD52	'nuclear DNA instability'
RAD54B	
RAE1	'nuclear DNA instability'
RALB	'intercellular communication impairment'
RALGAPA1	
RALY	'transcriptional alterations'
RAMP1	
RAN	'nuclear DNA instability'
RANBP9	
RAP1B	
RAP1GAP	
RAP2A	
RAPGEF4	
RARA	'transcriptional alterations'
RASA3	
RASA4	
RASGRP2	
RASIP1	
RASSF2	
RB1	'chromatin remodeling','transcriptional alterations'
RBBP4	'alterations in histone modifications','chromatin remodeling','transcriptional alterations'
RBFOX1	
RBFOX2	
RBL2	'transcriptional alterations'
RBM15	
RBM18	
RBM22	
RBM23	
RBM3	
RBM38	
RBM39	
RBM5	
RBM7	
RBM8A	
RBMS1	
RBMX	'transcriptional alterations','degradation of proteolytic systems'
RBPJ	'transcriptional alterations','stem cell exhaustion','sterile inflammation'
RCAN3	
RCOR3	'alterations in histone modifications','transcriptional alterations'
RDH5	'accumulation of reactive oxygen species'
RECQL4	'nuclear DNA instability','telomere attrition'
REL	'transcriptional alterations','sterile inflammation'
RELA	'transcriptional alterations','sterile inflammation'
RELN	'degradation of proteolytic systems','TOR pathway dysregulation'
RET	'degradation of proteolytic systems'
RFTN1	
RFX1	'transcriptional alterations'
RFX7	'transcriptional alterations'
RGL1	
RGN	
RGS20	
RGS4	
RGS7	
RHOA	'transcriptional alterations'
RHOB	
RHOBTB3	
RHOH	
RHOT1	'impairment of the mitochondrial integrity and biogenesis'
RIC8B	
RICTOR	'TOR pathway dysregulation','intercellular communication impairment'
RIN1	
RIN2	
RIN3	
RING1	'alterations in histone modifications','chromatin remodeling'
RIPOR2	
RLF	'alterations in histone modifications','transcriptional alterations','alterations in DNA methylation'
RNASE1	
RNF103	'degradation of proteolytic systems'
RNF114	'degradation of proteolytic systems'
RNF123	'degradation of proteolytic systems'
RNF144A	'degradation of proteolytic systems'
RNF5	'degradation of proteolytic systems'
RNF6	'degradation of proteolytic systems'
RNGTT	
ROGDI	
RP1	
RPA1	'nuclear DNA instability','telomere attrition'
RPA3	'nuclear DNA instability','telomere attrition'
RPL10	'transcriptional alterations'
RPL17	
RPL22	
RPL28	
RPL3	
RPL31	
RPN1	
RPP25L	
RPS21	
RPS26	
RPS3A	
RPS6KA3	'transcriptional alterations','intercellular communication impairment'
RPS6KA5	'alterations in histone modifications','transcriptional alterations','sterile inflammation'
RPS6KB1	'TOR pathway dysregulation'
RPS6KC1	
RPTOR	'nuclear DNA instability','TOR pathway dysregulation','intercellular communication impairment'
RRAGD	'TOR pathway dysregulation','intercellular communication impairment'
RRBP1	
RRM1	'mitochondrial DNA instability','nuclear DNA instability','accumulation of reactive oxygen species'
RRP1B	'transcriptional alterations'
RSL1D1	'senescent cells accumulation'
RTCA	
RTN4	'nuclear architecture impairment'
RTN4IP1	'accumulation of reactive oxygen species'
RTTN	
RUNX3	'transcriptional alterations'
RWDD1	
RXRA	'transcriptional alterations'
RXRG	'transcriptional alterations'
RYK	
RYR1	
S100A12	'sterile inflammation'
S100A4	
S100A8	'sterile inflammation','intercellular communication impairment','disabled macroautophagy'
S100A9	'sterile inflammation','intercellular communication impairment','disabled macroautophagy'
S100B	
S1PR1	'transcriptional alterations'
SACS	
SAFB	'transcriptional alterations'
SALL2	'transcriptional alterations'
SAMM50	'impairment of the mitochondrial integrity and biogenesis'
SATB1	'chromatin remodeling','transcriptional alterations'
SBDS	
SCAF11	
SCAF8	
SCAMP1	
SCAND1	
SCAPER	
SCD	'accumulation of reactive oxygen species'
SCML1	
SCN10A	
SCN2B	'intercellular communication impairment'
SCN3A	
SCN4B	
SCP2	
SCPEP1	'degradation of proteolytic systems'
SDC2	
SDC4	
SDHAF3	
SDHB	'accumulation of reactive oxygen species'
SDHC	'accumulation of reactive oxygen species'
SEC23A	
SEC61A1	
SEC63	
SEL1L3	
SELENOM	'accumulation of reactive oxygen species'
SELENOP	
SELL	
SELPLG	
SEMA3B	'intercellular communication impairment'
SEMA6D	
SENP7	'degradation of proteolytic systems'
SEPTIN10	
SEPTIN2	
SEPTIN4	
SEPTIN6	
SERBP1	'nuclear architecture impairment'
SERINC3	
SERPINA4	
SERPINE1	'senescent cells accumulation'
SERPINF1	
SERTAD2	
SETD9	
SF3A1	
SF3B2	
SFPQ	'nuclear DNA instability','alterations in histone modifications','transcriptional alterations'
SFRP1	'stem cell exhaustion','intercellular communication impairment'
SFRP2	'transcriptional alterations','intercellular communication impairment'
SFXN4	
SGK1	'nuclear DNA instability'
SGPP1	
SGTA	'degradation of proteolytic systems'
SH2B3	'stem cell exhaustion'
SH2D1A	'intercellular communication impairment'
SH3BP5	
SH3KBP1	'intercellular communication impairment'
SHC1	'INS/IGF-1 pathway dysregulation'
SIAH1	'degradation of proteolytic systems'
SIGLEC12	
SIN3A	'alterations in histone modifications','transcriptional alterations'
SIRPA	
SIRT1	'nuclear DNA instability','alterations in histone modifications','chromatin remodeling','transcriptional alterations','degradation of proteolytic systems','TOR pathway dysregulation','AMPK pathway dysregulation','senescent cells accumulation','intercellular communication impairment'
SIRT2	'alterations in histone modifications','chromatin remodeling','transcriptional alterations','degradation of proteolytic systems','disabled macroautophagy'
SIRT3	'alterations in histone modifications'
SIRT4	'nuclear DNA instability','impairment of the mitochondrial integrity and biogenesis'
SIRT5	'impairment of the mitochondrial integrity and biogenesis'
SIRT6	'nuclear DNA instability','alterations in histone modifications','chromatin remodeling','transcriptional alterations','senescent cells accumulation'
SIRT7	'nuclear DNA instability','alterations in histone modifications','chromatin remodeling','transcriptional alterations'
SIT1	
SKAP2	
SKIC2	
SKIC8	'alterations in histone modifications'
SKIL	'transcriptional alterations'
SLAMF7	
SLBP	
SLC12A2	'intercellular communication impairment'
SLC12A6	'intercellular communication impairment'
SLC13A1	
SLC14A1	
SLC15A4	
SLC16A14	
SLC16A3	
SLC19A1	
SLC25A11	
SLC25A12	
SLC25A19	
SLC25A27	
SLC25A28	
SLC26A6	
SLC27A3	
SLC2A13	
SLC38A1	
SLC39A11	
SLC41A1	
SLC43A2	
SLC44A2	
SLC4A4	
SLC6A3	
SLC7A5	'intercellular communication impairment'
SLC7A6	
SLC9A2	
SLCO3A1	
SLPI	
SLU7	
SLX1B	'nuclear DNA instability','telomere attrition'
SMAD2	'transcriptional alterations'
SMAD3	'transcriptional alterations'
SMAD4	'transcriptional alterations','stem cell exhaustion'
SMARCA4	'chromatin remodeling','transcriptional alterations'
SMARCA5	'nuclear DNA instability','chromatin remodeling','transcriptional alterations','alterations in DNA methylation'
SMARCE1	'chromatin remodeling','transcriptional alterations'
SMC3	'nuclear DNA instability','stem cell exhaustion'
SMC4	'nuclear DNA instability'
SMC5	'nuclear DNA instability','telomere attrition','senescent cells accumulation','stem cell exhaustion'
SMCHD1	'nuclear DNA instability','chromatin remodeling'
SMNDC1	
SMOC1	
SMOC2	
SNAI1	'chromatin remodeling','transcriptional alterations'
SNAI2	'transcriptional alterations'
SNAP23	
SNAPC1	'transcriptional alterations'
SNCA	'transcriptional alterations','impairment of the mitochondrial integrity and biogenesis','accumulation of reactive oxygen species','intercellular communication impairment'
SNCG	'intercellular communication impairment'
SNED1	
SNRNP27	
SNRNP70	
SNRPN	
SNTG2	
SNW1	'transcriptional alterations'
SOCS2	'INS/IGF-1 pathway dysregulation'
SOCS3	
SOD1	'accumulation of reactive oxygen species'
SOD2	'transcriptional alterations','impairment of the mitochondrial integrity and biogenesis','accumulation of reactive oxygen species'
SOD3	'accumulation of reactive oxygen species'
SON	
SORD	'accumulation of reactive oxygen species'
SORT1	
SOS2	'INS/IGF-1 pathway dysregulation'
SOX13	'transcriptional alterations'
SOX15	'transcriptional alterations'
SOX2	'transcriptional alterations','stem cell exhaustion'
SOX4	'transcriptional alterations','stem cell exhaustion'
SOX6	'transcriptional alterations'
SP1	'transcriptional alterations','intercellular communication impairment'
SP100	'nuclear DNA instability','telomere attrition','transcriptional alterations'
SPATS2L	
SPHK2	'alterations in histone modifications','chromatin remodeling'
SPON1	'degradation of proteolytic systems','changes in the extracellular matrix structure'
SPP1	'sterile inflammation'
SPRTN	'nuclear DNA instability','degradation of proteolytic systems'
SPRY2	
SPTBN1	
SPTSSA	
SPZ1	
SQSTM1	'transcriptional alterations','degradation of proteolytic systems','impairment of the mitochondrial integrity and biogenesis','disabled macroautophagy'
SREK1	
SRI	
SRP54	
SRP68	
SRP72	
SRRM2	
SRSF1	
SRSF10	
SRSF11	
SRSF5	
SRSF6	
SSNA1	
SST	'intercellular communication impairment'
SSTR1	
SSTR2	
SSTR3	'intercellular communication impairment'
SSTR5	
ST13	'impairment of proteins folding and stability'
ST6GAL1	
ST6GALNAC2	
ST8SIA1	
ST8SIA5	
STAG1	'nuclear DNA instability'
STAG2	'nuclear DNA instability'
STARD13	
STAT3	'transcriptional alterations','stem cell exhaustion','sterile inflammation'
STAT5A	'transcriptional alterations'
STAT5B	'transcriptional alterations'
STK10	
STK17A	
STK24	'intercellular communication impairment'
STK25	
STK38	
STK4	
STOM	
STRADB	
STUB1	'nuclear DNA instability','degradation of proteolytic systems'
STX5	
STX6	
STX7	
STYX	
SUB1	'transcriptional alterations'
SUCLA2	
SUCLG1	
SUMO1	'nuclear DNA instability','nuclear architecture impairment'
SUMO2	'transcriptional alterations'
SUMO3	
SUN1	'nuclear DNA instability','nuclear architecture impairment'
SUPV3L1	'nuclear DNA instability','impairment of the mitochondrial integrity and biogenesis'
SURF1	'accumulation of reactive oxygen species'
SVEP1	
SYAP1	'TOR pathway dysregulation'
SYDE2	
SYN2	'intercellular communication impairment'
SYNGR1	
TAF5	'alterations in histone modifications','transcriptional alterations','degradation of proteolytic systems'
TAF6L	'alterations in histone modifications','chromatin remodeling','transcriptional alterations','degradation of proteolytic systems'
TAF9	'nuclear DNA instability','alterations in histone modifications','transcriptional alterations','degradation of proteolytic systems'
TAFA5	
TARDBP	
TARS1	
TAS2R16	
TAX1BP3	'degradation of proteolytic systems'
TBC1D1	
TBC1D8B	
TBC1D9B	
TBCA	
TBK1	'transcriptional alterations','sterile inflammation'
TBKBP1	'sterile inflammation'
TBL1X	'alterations in histone modifications','transcriptional alterations','degradation of proteolytic systems'
TBL3	
TBP	'transcriptional alterations'
TBX3	'transcriptional alterations','senescent cells accumulation','stem cell exhaustion'
TBXA2R	'sterile inflammation'
TCAF1	
TCEAL1	
TCERG1	'transcriptional alterations'
TCF3	'transcriptional alterations'
TCIRG1	'sterile inflammation','disabled macroautophagy'
TELO2	'nuclear DNA instability','telomere attrition','TOR pathway dysregulation'
TEP1	'nuclear DNA instability','telomere attrition'
TERC	
TERF1	'nuclear DNA instability','telomere attrition'
TERF2	'nuclear DNA instability','telomere attrition','senescent cells accumulation'
TERT	'nuclear DNA instability','telomere attrition','impairment of the mitochondrial integrity and biogenesis','senescent cells accumulation'
TESK1	
TFAP2A	'transcriptional alterations'
TFDP1	'transcriptional alterations'
TFDP2	'transcriptional alterations'
TGFA	
TGFB1	'transcriptional alterations','degradation of proteolytic systems','sterile inflammation','changes in the extracellular matrix structure'
TGFBR1	
TGFBR2	
TGFBR3	
TGIF1	'transcriptional alterations'
TGM2	'alterations in histone modifications','degradation of proteolytic systems'
TGOLN2	
TH	'accumulation of reactive oxygen species','intercellular communication impairment'
THY1	'intercellular communication impairment'
TIAM1	
TICAM1	'sterile inflammation'
TIMELESS	'nuclear DNA instability'
TIMM17A	
TIMM21	
TIMM8A	'impairment of the mitochondrial integrity and biogenesis'
TIMP1	
TIMP2	
TIRAP	'sterile inflammation'
TJP2	
TLE1	
TLN1	
TLN2	
TLR1	'sterile inflammation'
TLR10	'sterile inflammation'
TLR2	'transcriptional alterations','sterile inflammation'
TLR3	'transcriptional alterations'
TLR4	'transcriptional alterations','sterile inflammation'
TLR5	'sterile inflammation'
TLR7	'transcriptional alterations','sterile inflammation'
TLR8	'sterile inflammation'
TM2D1	
TM4SF1	
TMBIM4	
TMBIM6	'disabled macroautophagy'
TMEM123	
TMEM131L	
TMEM167B	
TMEM18	
TMEM185A	
TMEM47	
TMEM9	
TMPO	
TMPRSS2	'degradation of proteolytic systems'
TMTC2	
TMX1	'accumulation of reactive oxygen species'
TNF	'transcriptional alterations','sterile inflammation'
TNFAIP8	
TNFRSF10B	
TNFRSF21	
TNFRSF4	'sterile inflammation'
TNFSF14	
TNFSF8	'transcriptional alterations','intercellular communication impairment'
TNKS2	
TNNI3K	'intercellular communication impairment'
TNNT1	
TNRC6A	'intercellular communication impairment'
TOB1	
TOLLIP	'degradation of proteolytic systems','sterile inflammation','disabled macroautophagy'
TOMM20	'impairment of the mitochondrial integrity and biogenesis'
TOMM40	'impairment of the mitochondrial integrity and biogenesis'
TOP1	'nuclear DNA instability','chromatin remodeling'
TOP2B	'nuclear DNA instability'
TOP3B	'nuclear DNA instability'
TOPORS	'nuclear DNA instability','transcriptional alterations','degradation of proteolytic systems'
TOX	'transcriptional alterations'
TP53	'mitochondrial DNA instability','nuclear DNA instability','chromatin remodeling','transcriptional alterations','impairment of the mitochondrial integrity and biogenesis','accumulation of reactive oxygen species','senescent cells accumulation','stem cell exhaustion','intercellular communication impairment','disabled macroautophagy'
TP53BP1	'nuclear DNA instability','transcriptional alterations'
TP53I11	
TP53INP1	'disabled macroautophagy'
TP53TG1	
TP63	'chromatin remodeling','transcriptional alterations','senescent cells accumulation','stem cell exhaustion','intercellular communication impairment'
TP73	'nuclear DNA instability','transcriptional alterations'
TPBG	'intercellular communication impairment'
TPD52L2	
TPI1	
TPM3	
TPP2	'degradation of proteolytic systems'
TPPP	
TPPP3	
TPST2	
TRAF1	
TRAK2	'impairment of the mitochondrial integrity and biogenesis'
TRAM2	
TRAP1	'impairment of proteins folding and stability'
TRAPPC10	
TRIB2	
TRIM23	
TRIM33	'transcriptional alterations'
TRIM38	'degradation of proteolytic systems'
TRIM55	
TRIM58	'degradation of proteolytic systems'
TRIM72	'degradation of proteolytic systems','INS/IGF-1 pathway dysregulation'
TRIO	
TRIOBP	
TRIP12	'nuclear DNA instability','degradation of proteolytic systems'
TRMT112	'alterations in histone modifications'
TRPV1	'transcriptional alterations','sterile inflammation'
TSC22D1	'transcriptional alterations'
TSC22D3	'transcriptional alterations'
TSNAX	
TSPAN5	
TSPAN6	
TSPYL2	'chromatin remodeling'
TST	
TTC4	
TTC9	
TTF2	'nuclear DNA instability','chromatin remodeling'
TTLL12	
TTR	
TUBA3C	
TUBB	
TUBB2A	
TUBB6	
TWF1	
TXK	'transcriptional alterations'
TXN	'transcriptional alterations','accumulation of reactive oxygen species'
TXNDC11	
TXNDC9	
TXNIP	'transcriptional alterations'
TXNRD1	'accumulation of reactive oxygen species'
TYMS	
U2AF1	
UBA2	
UBE2B	'nuclear DNA instability','alterations in histone modifications','degradation of proteolytic systems'
UBE2D2	'degradation of proteolytic systems'
UBE2D3	'nuclear DNA instability','transcriptional alterations','degradation of proteolytic systems'
UBE2H	'degradation of proteolytic systems'
UBE2M	
UBE2S	'degradation of proteolytic systems'
UBL3	
UBL5	
UBP1	'transcriptional alterations'
UBR5	'nuclear DNA instability'
UCHL1	'degradation of proteolytic systems','intercellular communication impairment'
UCHL3	'degradation of proteolytic systems'
UCP1	'transcriptional alterations'
UCP2	'intercellular communication impairment'
UCP3	
UGP2	
UPF1	'nuclear DNA instability','telomere attrition'
UPF2	
UPF3A	
UQCRB	
UQCRC1	'accumulation of reactive oxygen species'
UQCRC2	'degradation of proteolytic systems'
UQCRFS1	'accumulation of reactive oxygen species'
UQCRH	'accumulation of reactive oxygen species'
URM1	
UROS	
USE1	
USF2	'transcriptional alterations','intercellular communication impairment'
USO1	
USP1	'nuclear DNA instability','degradation of proteolytic systems'
USP10	'nuclear DNA instability','degradation of proteolytic systems','disabled macroautophagy'
USP13	'degradation of proteolytic systems','disabled macroautophagy'
USP14	'degradation of proteolytic systems','intercellular communication impairment'
USP2-AS1	
USP25	'degradation of proteolytic systems'
USP3	'nuclear DNA instability','alterations in histone modifications','degradation of proteolytic systems'
USP42	'degradation of proteolytic systems'
USP46	'degradation of proteolytic systems'
USP54	'degradation of proteolytic systems'
USP6	'degradation of proteolytic systems'
UTS2	'intercellular communication impairment'
UXS1	
UXT	'transcriptional alterations'
VAMP3	
VAMP4	
VASH1	'degradation of proteolytic systems','senescent cells accumulation'
VAT1	'accumulation of reactive oxygen species'
VCAN	'changes in the extracellular matrix structure'
VCL	
VCP	'nuclear DNA instability','degradation of proteolytic systems','disabled macroautophagy'
VDAC1P1	
VEGFA	'transcriptional alterations'
VEGFB	
VEGFC	
VEGFD	
VGLL4	
VHL	'transcriptional alterations','degradation of proteolytic systems'
VIM	
VLDLR	
VPS26A	
VRK2	
VRK3	
VWF	'changes in the extracellular matrix structure'
WDR12	
WDR33	'nuclear DNA instability'
WDR4	'nuclear DNA instability'
WDR6	
WDR77	'alterations in histone modifications','transcriptional alterations'
WDR87	
WDR91	'degradation of proteolytic systems'
WFS1	'transcriptional alterations','degradation of proteolytic systems'
WIF1	
WIPF1	'impairment of proteins folding and stability'
WNK1	
WNT1	'transcriptional alterations','degradation of proteolytic systems','INS/IGF-1 pathway dysregulation','senescent cells accumulation','intercellular communication impairment'
WNT10A	'stem cell exhaustion'
WNT10B	'transcriptional alterations'
WNT11	
WNT16	'senescent cells accumulation'
WNT2	'transcriptional alterations','intercellular communication impairment'
WNT2B	'intercellular communication impairment'
WNT3	
WNT3A	'transcriptional alterations','stem cell exhaustion'
WNT4	'intercellular communication impairment'
WNT5A	'transcriptional alterations','intercellular communication impairment'
WNT5B	
WNT6	'intercellular communication impairment'
WNT7A	'transcriptional alterations','stem cell exhaustion'
WNT7B	
WNT9A	
WNT9B	'stem cell exhaustion','intercellular communication impairment'
WRN	'nuclear DNA instability','telomere attrition','senescent cells accumulation','intercellular communication impairment'
WSB1	
WWOX	'transcriptional alterations','accumulation of reactive oxygen species'
XBP1	'transcriptional alterations','degradation of proteolytic systems','intercellular communication impairment','disabled macroautophagy'
XPA	'nuclear DNA instability'
XPO7	
XRCC1	'nuclear DNA instability','telomere attrition'
XRCC2	'nuclear DNA instability'
XRCC5	'nuclear DNA instability','telomere attrition','stem cell exhaustion'
XRCC6	'nuclear DNA instability','telomere attrition','transcriptional alterations'
YAP1	'nuclear DNA instability','transcriptional alterations','stem cell exhaustion'
YES1	'transcriptional alterations'
YWHAB	
YWHAE	
YWHAZ	'transcriptional alterations'
YY1	'nuclear DNA instability','telomere attrition','chromatin remodeling','transcriptional alterations'
ZBTB1	'nuclear DNA instability','chromatin remodeling','transcriptional alterations'
ZBTB18	'transcriptional alterations'
ZBTB25	'transcriptional alterations'
ZBTB43	'transcriptional alterations'
ZBTB44	
ZBTB8A	'transcriptional alterations'
ZBTB8OS	
ZC3H7A	
ZC3HAV1	
ZC3HC1	
ZCCHC14	
ZCCHC3	
ZCRB1	
ZEB1	'transcriptional alterations'
ZEB2	'transcriptional alterations'
ZER1	'degradation of proteolytic systems'
ZFAND2A	'degradation of proteolytic systems'
ZFHX3	'transcriptional alterations'
ZFP36	'transcriptional alterations','stem cell exhaustion'
ZFP36L1	
ZFP36L2	'stem cell exhaustion'
ZFP64	'transcriptional alterations'
ZFP69B	'transcriptional alterations'
ZFTRAF1	
ZFYVE28	
ZFYVE9	
ZHX2	'transcriptional alterations','stem cell exhaustion'
ZMAT3	'nuclear DNA instability'
ZMIZ1	'transcriptional alterations','senescent cells accumulation'
ZMIZ2	'transcriptional alterations'
ZMPSTE24	'nuclear DNA instability','nuclear architecture impairment','alterations in histone modifications','alterations in DNA methylation','degradation of proteolytic systems','TOR pathway dysregulation','AMPK pathway dysregulation','senescent cells accumulation'
ZNF131	'transcriptional alterations'
ZNF136	'transcriptional alterations'
ZNF141	'transcriptional alterations'
ZNF19	'transcriptional alterations'
ZNF22	'transcriptional alterations'
ZNF226	'transcriptional alterations'
ZNF232	'transcriptional alterations'
ZNF264	'transcriptional alterations'
ZNF266	'transcriptional alterations'
ZNF267	'transcriptional alterations'
ZNF273	'transcriptional alterations'
ZNF274	'transcriptional alterations'
ZNF318	
ZNF32	'transcriptional alterations'
ZNF415	'transcriptional alterations'
ZNF419	'transcriptional alterations'
ZNF423	'transcriptional alterations'
ZNF430	'transcriptional alterations'
ZNF454	'transcriptional alterations'
ZNF532	
ZNF557	'transcriptional alterations'
ZNF571	'transcriptional alterations'
ZNF576	'transcriptional alterations'
ZNF577	'transcriptional alterations'
ZNF586	'transcriptional alterations'
ZNF592	
ZNF652	'transcriptional alterations'
ZNF785	'transcriptional alterations'
ZNF91	'transcriptional alterations'
ZSCAN18	'transcriptional alterations'
ZSCAN5A	'transcriptional alterations'
ZW10	'nuclear DNA instability'